   ##########        
   #^^^^^^^^####     
   #^#^#^^^^#..#     
   #^^^^^^^^00.#     
   #.....^###..####  
 #########..0.#...#  
 #.....0...0.0..0.#  
 #..#....#..0.0#..#  
 ##.#####...#..#..#  
 #.0.....#...####.#  
##..0#...#.##..#..#  
#....##0###....#..## 
#.0....0.#..#..#...# 
#####....#.##.#.##.##
    #0#.#..0..0.0...#
    #@#..0#000..#...#
    ###..0......#####
      ##..#..#..#    
       ##########    

